#############################
#S   #       #       #     E#
### #### ## ###### #### #####
#   #     #     #   #   #   #
# ####### ##### # ### # # ###
#   #   #   #   #     #     #
### # # ### # ####### ### ###
#   # #     # #   # # #     #
# ### ### ### # ### # ##### #
#     #   #   #     #       #
# ######### ###### ## #######
#     #     #   #   #     # #
##### ##### ### # ### ### # #
#   #     #     #     # # # #
### #### ## ####### ### # # #
#   #     # #     #   #   # #
# ### ### ### ### ### ##### #
# #   #   #     # #   #     #
# ### # ##### ### ### ##### #
#     #   #   #   #         #
# ######### ##### ## #### ###
#       #     #       #     #
##### ##### ### ### ####### #
#           #     #     #   #
#############################
