##################
#        #       #
### #### # #######
#   #    #       #
### ## #### #### #
#   #   #   #    #
##### #   # # ####
#E  #   #   #    #
### # # ###### ###
#     #  S   #   #
### ####### ## ###
#   #            #
# ### #### ## ####
#   #  # # #     #
### # ## # ### ###
#     #    #     #
##################
